0 2 0 3 7 7 7 7 7 3 0 2 0 0 0 0
0 0 0 3 7 7 7 7 7 3 0 0 0 0 2 0
0 0 2 3 7 7 7 7 7 3 0 2 0 2 0 0
0 0 0 3 3 3 7 3 3 3 0 0 0 0 0 0
0 0 0 0 2 0 7 2 0 0 0 0 0 0 0 0
0 0 0 2 0 0 7 0 0 0 0 0 0 0 0 0
7 7 7 7 7 7 7 7 7 7 7 7 7 7 7 7
0 0 2 0 0 0 0 0 0 7 0 0 2 0 0 0
0 6 0 0 0 0 2 0 0 7 0 0 6 1 1 1
0 0 0 6 0 0 0 0 0 7 0 2 1 4 4 4
0 2 6 0 6 0 2 0 0 7 1 1 4 4 4 4
0 0 0 2 0 0 0 0 0 1 4 4 4 4 4 4